[
  //[enum °ª] 0 - EMPTY, 1 - BLOCK, 2 - ROCK, 3 - SPECIALROCK

  [ 2, 2, 2, 2, 0, 2, 2, 3, 2, 2, 0, 2, 2, 2, 2 ],
  [ 1, 0, 0, 2, 2, 1, 2, 1, 2, 1, 2, 2, 0, 0, 1 ],
  [ 2, 0, 1, 2, 2, 3, 2, 1, 2, 3, 2, 2, 1, 0, 2 ],
  [ 2, 1, 2, 2, 1, 2, 2, 0, 2, 2, 1, 2, 2, 1, 2 ],
  [ 2, 1, 2, 2, 1, 2, 2, 0, 2, 2, 1, 2, 2, 1, 2 ],
  [ 2, 0, 1, 2, 2, 3, 2, 1, 2, 3, 2, 2, 1, 0, 2 ],
  [ 1, 0, 0, 2, 2, 1, 2, 1, 2, 1, 2, 2, 0, 0, 1 ],
  [ 2, 2, 2, 2, 0, 2, 2, 3, 2, 2, 0, 2, 2, 2, 2 ]
]
